20 21 20 21 20 21 20 21 20 21 20 21 20 21 20 21 20 21 20 21 20 21 20 21 20 21 20 21 20 21 20 21 20 21 20 21 20 21 20 21 20 21 20 21 20 21 20 21 20 21
18 19 18 19 18 19 18 19 18 19 18 19 18 19 18 19 18 19 18 19 18 19 18 19 18 19 18 19 18 19 18 19 18 19 18 19 18 19 18 19 18 19 18 19 18 19 18 19 18 19
20 21 20 21 20 21 20 21 20 21 20 21 20 21 20 21 20 21 20 21 20 21 20 21 20 21 20 21 20 21 20 21 20 21 20 21 20 21 20 21 20 21 20 21 20 21 20 21 20 21
18 19 18 19 18 19 18 19 18 19 18 19 18 19 18 19 18 19 18 19 18 19 18 19 18 19 18 19 18 19 18 19 18 19 18 19 18 19 18 19 18 19 18 19 18 19 18 19 18 19
20 21 20 21 20 21 20 21 20 21 20 21 20 21 20 21 20 21 20 21 20 21 20 21 20 21 20 21 20 21 20 21 20 21 20 21 20 21 20 21 20 21 20 21 20 21 20 21 20 21
18 19 18 19 18 19 18 19 18 19 18 19 18 19 18 19 18 19 18 19 18 19 18 19 18 19 18 19 18 19 18 19 18 19 18 19 18 19 18 19 18 19 18 19 18 19 18 19 18 19
20 21 20 21 20 21 20 21 17 16 17 16 17 16 17 16 17 16 17 16 17 16 17 16 17 16 17 16 17 16 17 16 17 16 17 16 17 16 17 16 17 16 20 21 20 21 20 21 20 21
18 19 18 19 18 19 18 19 15 0  0  0  0  0  0  0  12 13 0  0  0  0  0  0  0  0  0  0  0  0  0  0  0  0  0  0  0  0  0  0  0  14 18 19 18 19 18 19 18 19
20 21 20 21 20 21 20 21 17 0  0  0  0  1  1  1  0  0  0  0  0  0  2  0  0  1  0  0  2  0  0  0  0  0  0  0  0  0  0  0  0  16 20 21 20 21 20 21 20 21
18 19 18 19 18 19 18 19 15 0  0  0  0  1  0  1  0  0  0  0  0  0  0  0  0  0  0  0  0  0  0  0  0  0  0  0  0  0  0  0  0  14 18 19 18 19 18 19 18 19
20 21 20 21 20 21 20 21 17 0  0  0  0  1  1  1  0  0  0  0  0  0  1  0  0  2  0  0  2  0  0  0  0  0  0  0  0  0  0  0  0  16 20 21 20 21 20 21 20 21
18 19 18 19 18 19 18 19 15 23 23 23 3  4  4  4  4  4  5  23 23 23 2  0  0  23 23 23 23 23 23 23 23 23 23 23 23 23 23 0  0  14 18 19 18 19 18 19 18 19
20 21 20 21 20 21 20 21 17 24 24 24 6  7  7  7  7  7  8  24 24 24 0  0  0  24 24 24 24 24 24 24 24 24 24 24 24 24 24 0  0  16 20 21 20 21 20 21 20 21
18 19 18 19 18 19 18 19 15 2  23 23 6  7  7  7  7  7  8  0  0  23 0  0  0  23 0  0  0  0  0  0  0  0  0  0  0  0  0  0  0  14 18 19 18 19 18 19 18 19
20 21 20 21 20 21 20 21 17 23 24 24 6  7  7  7  7  7  8  0  0  24 0  0  0  24 0  0  0  0  0  0  0  0  0  0  0  0  0  0  0  16 20 21 20 21 20 21 20 21
18 19 18 19 18 19 18 19 15 24 0  23 6  7  7  7  22 10 11 0  0  23 0  0  0  23 23 23 23 23 23 23 23 23 23 23 23 23 23 0  23 14 18 19 18 19 18 19 18 19
20 21 20 21 20 21 20 21 17 0  0  24 6  7  7  7  8  0  0  0  0  24 0  0  0  24 24 24 24 24 24 24 24 24 24 24 24 24 24 0  24 16 20 21 20 21 20 21 20 21
18 19 18 19 18 19 18 19 15 0  0  0  6  7  7  7  8  0  0  0  0  23 0  0  0  0  0  0  0  0  0  0  0  0  0  0  0  0  0  0  25 14 18 19 18 19 18 19 18 19
20 21 20 21 20 21 20 21 17 0  0  0  9  10 10 10 11 2  0  0  0  24 0  0  0  0  0  0  0  0  0  0  0  0  0  0  0  0  0  0  25 16 20 21 20 21 20 21 20 21
18 19 18 19 18 19 18 19 15 0  0  0  0  0  0  0  0  0  0  0  0  23 23 23 23 23 0  0  23 23 23 23 1  0  23 0  0  23 23 23 23 14 18 19 18 19 18 19 18 19
20 21 20 21 20 21 20 21 17 0  0  0  0  0  0  0  0  0  0  0  0  24 24 24 24 24 1  0  24 24 24 24 23 23 24 0  0  24 24 24 24 16 20 21 20 21 20 21 20 21
18 19 18 19 18 19 18 19 15 0  0  0  0  0  0  0  0  0  0  0  23 0  0  0  23 23 23 23 23 0  0  0  24 24 23 0  0  23 14 15 0  14 18 19 18 19 18 19 18 19
20 21 20 21 20 21 20 21 17 0  0  0  0  2  0  0  0  0  0  23 24 0  0  0  24 24 24 24 24 0  0  0  0  0  24 0  0  24 16 17 0  16 20 21 20 21 20 21 20 21
18 19 18 19 18 19 18 19 15 0  0  0  0  23 23 0  0  0  0  24 23 0  0  0  0  0  0  23 0  0  0  0  0  0  23 0  0  23 0  0  0  14 18 19 18 19 18 19 18 19
20 21 20 21 20 21 20 21 17 14 15 0  0  24 24 23 23 12 13 23 24 0  1  0  0  0  0  24 0  0  0  0  0  1  24 0  0  24 0  0  0  16 20 21 20 21 20 21 20 21
18 19 18 19 18 19 18 19 15 16 17 0  0  0  0  24 24 12 13 24 0  0  0  1  0  0  0  23 0  0  1  0  0  0  23 0  0  23 0  0  0  14 18 19 18 19 18 19 18 19
20 21 20 21 20 21 20 21 17 14 15 25 0  0  0  0  0  0  0  0  0  0  0  2  0  0  0  24 23 0  0  0  0  0  24 0  0  24 0  0  0  16 20 21 20 21 20 21 20 21
18 19 18 19 18 19 18 19 15 16 17 0  0  0  23 0  23 0  0  23 23 0  2  2  1  0  0  0  24 0  0  0  0  12 13 0  0  0  0  0  0  14 18 19 18 19 18 19 18 19
20 21 20 21 20 21 20 21 17 0  14 15 0  0  24 0  24 23 23 24 24 14 15 0  0  0  0  0  0  0  0  0  0  0  0  0  0  0  0  0  0  16 20 21 20 21 20 21 20 21
18 19 18 19 18 19 18 19 15 0  16 17 0  0  0  0  0  24 24 0  0  16 17 14 15 0  0  0  0  0  0  0  0  1  0  0  0  1  0  0  0  14 18 19 18 19 18 19 18 19
20 21 20 21 20 21 20 21 17 0  0  0  0  0  12 13 26 27 0  0  0  0  0  16 17 14 15 14 15 3  4  4  4  4  4  4  4  4  4  4  5  16 20 21 20 21 20 21 20 21
18 19 18 19 18 19 18 19 15 0  0  0  0  0  14 15 16 17 0  0  0  0  0  0  0  16 17 16 17 6  7  7  7  7  7  7  7  7  7  7  8  14 18 19 18 19 18 19 18 19
20 21 20 21 20 21 20 21 17 0  2  0  0  2  16 17 14 15 0  0  0  0  0  0  0  0  0  0  0  6  7  7  7  7  7  7  7  7  7  7  8  16 20 21 20 21 20 21 20 21
18 19 18 19 18 19 18 19 15 0  2  0  0  2  0  1  16 17 0  0  0  0  0  0  0  0  0  0  0  6  7  7  7  7  7  7  7  7  7  7  8  14 18 19 18 19 18 19 18 19
20 21 20 21 20 21 20 21 17 0  2  0  0  0  12 13 0  0  0  0  0  0  0  0  0  0  0  0  0  6  7  7  7  7  7  7  7  7  7  7  8  16 20 21 20 21 20 21 20 21
18 19 18 19 18 19 18 19 15 0  0  0  0  0  1  1  0  0  0  2  0  0  0  0  0  0  0  0  0  6  7  7  7  7  7  7  7  7  7  7  8  14 18 19 18 19 18 19 18 19
20 21 20 21 20 21 20 21 17 0  0  0  0  0  1  1  0  0  0  0  0  0  0  0  0  0  0  0  0  9  10 10 10 10 10 10 10 10 10 10 11 16 20 21 20 21 20 21 20 21
18 19 18 19 18 19 18 19 15 0  0  0  0  0  1  2  2  0  0  0  0  0  0  0  0  0  0  0  0  0  0  0  0  0  0  0  0  0  0  0  0  14 18 19 18 19 18 19 18 19
20 21 20 21 20 21 20 21 17 0  2  0  1  25 2  2  2  0  0  0  0  0  0  0  0  0  0  0  0  0  0  0  0  0  0  0  0  0  0  0  0  16 20 21 20 21 20 21 20 21
18 19 18 19 18 19 18 19 15 0  2  0  25 12 13 2  2  0  0  2  0  0  0  0  0  0  0  2  0  0  0  0  0  0  0  0  0  0  0  0  2  14 18 19 18 19 18 19 18 19
20 21 20 21 20 21 20 21 17 0  2  0  2  2  0  2  2  2  0  0  0  0  0  0  0  0  0  0  0  0  0  2  0  0  0  0  0  0  0  0  0  16 20 21 20 21 20 21 20 21
18 19 18 19 18 19 18 19 15 12 13 0  2  0  0  2  0  0  0  0  0  0  0  0  0  0  0  0  0  0  0  0  1  0  0  0  0  0  0  0  0  14 18 19 18 19 18 19 18 19
20 21 20 21 20 21 20 21 17 2  2  25 2  0  0  0  0  0  0  0  0  0  0  0  0  0  0  0  0  0  0  0  0  0  2  0  0  0  0  0  0  16 20 21 20 21 20 21 20 21
18 19 18 19 18 19 18 19 15 1  12 13 2  0  0  0  0  0  0  0  0  0  0  0  0  0  2  0  0  0  0  0  0  0  0  0  0  0  0  0  0  14 18 19 18 19 18 19 18 19
20 21 20 21 20 21 20 21 19 15 14 15 14 15 14 15 14 15 14 15 14 15 14 15 14 15 14 15 14 15 14 15 14 15 14 15 14 15 14 15 14 21 20 21 20 21 20 21 20 21
18 19 18 19 18 19 18 19 18 19 18 19 18 19 18 19 18 19 18 19 18 19 18 19 18 19 18 19 18 19 18 19 18 19 18 19 18 19 18 19 18 19 18 19 18 19 18 19 18 19
20 21 20 21 20 21 20 21 20 21 20 21 20 21 20 21 20 21 20 21 20 21 20 21 20 21 20 21 20 21 20 21 20 21 20 21 20 21 20 21 20 21 20 21 20 21 20 21 20 21
18 19 18 19 18 19 18 19 18 19 18 19 18 19 18 19 18 19 18 19 18 19 18 19 18 19 18 19 18 19 18 19 18 19 18 19 18 19 18 19 18 19 18 19 18 19 18 19 18 19
20 21 20 21 20 21 20 21 20 21 20 21 20 21 20 21 20 21 20 21 20 21 20 21 20 21 20 21 20 21 20 21 20 21 20 21 20 21 20 21 20 21 20 21 20 21 20 21 20 21
18 19 18 19 18 19 18 19 18 19 18 19 18 19 18 19 18 19 18 19 18 19 18 19 18 19 18 19 18 19 18 19 18 19 18 19 18 19 18 19 18 19 18 19 18 19 18 19 18 19


0  1  2  3  4  5  6  7  8  9 10 11 12 13 14 15 16 17 18 19 20 21 22 23 24 25 26 27 28 29 30 31 32 33 34 35 36 37 38 39 40 41 42 43 44 45 46 47 48 49