30 31 31 31 31 31 31 31 31 31 31 31 31 31 31 31 31 31 31 32
30 35 35 35 35 35 35 35 35 35 35 35 35 35 35 35 35 35 35 32
30 35 35 35 35 35 35 35 35 35 35 35 35 35 35 35 35 35 35 32
30 35 35 35 35 35 35 35 35 35 35 35 35 35 35 35 35 35 35 32
30 35 35 35 35 35 35 35 35 35 35 35 35 35 35 35 35 35 35 32
30 35 35 35 35 35 35 35 35 35 35 35 35 35 35 35 35 35 35 32
30 35 35 35 35 35 35 35 35 35 35 35 35 35 35 35 35 35 35 32
30 35 35 35 35 35 35 35 35 35 35 35 35 35 35 35 35 35 35 32
30 35 35 35 35 35 35 35 35 35 35 35 35 35 35 35 35 35 35 32
30 35 35 35 35 35 35 35 35 35 35 35 35 35 35 35 35 35 35 32
30 35 35 35 35 35 35 35 35 35 35 35 35 35 35 35 35 35 35 32
30 35 35 35 35 35 35 35 35 35 35 35 35 35 35 35 35 35 35 32
30 35 35 35 35 35 35 35 35 35 35 35 35 35 35 35 35 35 35 32
30 35 35 35 35 35 35 35 35 35 35 35 35 35 35 35 35 35 35 32
30 35 35 35 35 35 35 35 35 35 35 35 35 35 35 35 35 35 35 32
30 35 35 35 35 35 35 35 35 35 35 35 35 35 35 35 35 35 35 32
30 35 35 35 35 35 35 35 35 35 35 35 35 35 35 35 35 35 35 32
30 35 35 35 35 35 35 35 35 35 35 35 35 35 35 35 35 35 35 32
30 35 35 35 35 35 35 35 35 35 35 35 35 35 35 35 35 35 35 32
36 37 37 37 37 37 37 37 30 34 34 32 37 37 37 37 37 37 37 41
99 99 99 99 99 99 99 99 30 34 34 32 99 99 99 99 99 99 99 99
99 99 99 99 99 99 99 99 30 34 34 32 99 99 99 99 99 99 99 99
99 99 99 99 99 99 99 99 30 34 34 32 99 99 99 99 99 99 99 99
99 99 99 99 99 99 30 31 31 34 34 31 31 32 99 99 99 99 99 99
99 99 99 99 99 99 30 34 34 34 34 34 34 32 99 99 99 99 99 99
99 99 99 99 99 99 30 34 34 34 34 34 34 32 99 99 99 99 99 99
99 99 99 99 99 99 30 34 34 34 34 34 34 32 99 99 99 99 99 99
99 99 99 99 99 99 30 34 34 34 34 34 34 32 99 99 99 99 99 99
99 99 99 99 99 99 30 34 34 34 34 34 34 32 99 99 99 99 99 99
99 99 99 99 99 99 30 34 34 34 34 34 34 32 99 99 99 99 99 99
99 99 99 99 99 99 36 37 37 37 37 37 37 41 99 99 99 99 99 99

 0  1  2  3  4  5  6  7  8  9 10 11 12 13 14 15 16 17 18 19